I	ɪ
E	e	æ
e	e
E:	ɛ
Y:	eu
O:	ɔ
E+	ɛɪ
Y+	œy
A+	ɑu
E~	ai
A~	an
O~	oi
Y~	Y
A	ɑ
a	a
O	ɔ
o	o
Y	ʏ
y	y
i	i
o	oʊ
ow	oʊ
u	u
@	ʌ
A+	aʊ
Aj	aɪ
Oj	ɔɪ
p	p
b	b
t	t
d	d
k	k
g	ɡ
G	ɣ
f	f
v	v
s	s
z	z
S	ʃ
Z	ʒ
t	t
d	ð
h	h
N	ŋ
m	m
n	n
l	l
r	ɹ
w	w
j	j
J	ʒ
x	x
2	œ
